#########
#   .   #
#   $   #
# .$@$. #
#   $   #
#   .   #
#########
;
########
#. @   #
####   #
   ##  ##
   #    #
####  $ #
# . $   #
#########